####################
...................#
...................#
...................#
........######.....#
......##............
....##..............
.######.............
#######.............
####################
####################