####################
....................
....................
....................
..........####......
....................
....................
.#..................
###.................
####################
####################