####################
#####...............
..................##
....................
..........####......
....................
....##..............
....................
###.................
####################
####################