####################
...............###..
....................
....................
.....###############
....................
.............#####..
.#.......#..........
###.................
####################
####################