####################
#####...........##..
.....##.............
....................
..........####......
....................
....................
.#......#.......#...
###....###...###....
####################
####################