####################
.##.................
.....##.............
.......###..........
..........####......
....................
....................
....................
########............
####################
####################