####################
.............#######
..............######
....................
..........####......
...............####.
#...................
###.................
#####...............
####################
####################