####################
....................
..######............
....................
............###.....
....................
..#.................
.#..#...............
........######......
####################
####################