####################
###....###..........
....................
...###.......####...
..........####......
....................
....................
.#.........#####....
################....
####################
####################